1111111111111
1111111111111
1111111111111
1111111111111
1111111111111
1111111111111
1111111111111
1111111111111
1111111111111
1111111111111
1111111111221
1111111111221
1111111111111
---
1111111111111
1000100000001
1000100000001
1000100000001
1000110110001
1000100010001
1000100010001
1000100010001
1000110110001
1000000010001
1000000010001
1000000010001
1111111111111
---
1111111111111
1000000000001
1000000000001
1000000000001
1000011100001
1000000000001
1000000000001
1000000000001
1000011100001
1000000000001
1000000000001
1000000000001
1111111111111
---
1111111111111
1000000000001
1000000000001
1000000000001
1000000000001
1000000000001
1000000000001
1000000000001
1000000000001
1000000000001
1000000000001
1000000000001
1111111111111
---
1111111111111
1000000000001
1000000000001
1000000000001
1000000000001
1000000000001
1000000000001
1000000000001
1000000000001
1000000000001
1000000000001
1000000000001
1111111111111
---
1111111111111
1000000000001
1000000000001
1000000000001
1000000000001
1000000000001
1000000000001
1000000000001
1000000000001
1000000000001
1000000000001
1000000000001
1111111111111
---
1111111111111
1000000000001
1000000000001
1000000000001
1000000000001
1000000000001
1000000000001
1000000000001
1000000000001
1000000000001
1000000000001
1000000000001
1111111111111
---
1111111111111
1000000000001
1000000000001
1000000000001
1000000000001
1000000000001
1000000000001
1000000000001
1000000000001
1000000000001
1000000000001
1000000000001
1111111111111
---
1111111111111
1000000000001
1000000000001
1000000000001
1000000000001
1000000000001
1000000000001
1000000000001
1000000000001
1000000000001
1000000000001
1000000000001
1111111111111
---
1111111111111
1000000000001
1000000000001
1000000000001
1000000000001
1000000000001
1000000000001
1000000000001
1000000000001
1000000000001
1000000000001
1000000000001
1111111111111
---
1111111111111
1000000000001
1000000000001
1000000000001
1000000000001
1000000000001
1000000000001
1000000000001
1000000000001
1000000000001
1000000000001
1000000000001
1111111111111
---
1111111111111
1000000000001
1000000000001
1000000000001
1000000000001
1000000000001
1000000000001
1000000000001
1000000000001
1000000000001
1000000000001
1000000000001
1111111111111
---
1111111111111
1111111111111
1111111111111
1111111111111
1111111111111
1111111111111
1111111111111
1111111111111
1111111111111
1111111111111
1111111111111
1111111111111
1111111111111